"filename", "language", "PHP", "SCSS", "JavaScript", "comment", "blank", "total"
"c:\Users\Lorelvis\Documents\MEGASync\Programación\Desarrollo Web\Cursos\Desarrollo web completo con HTML5, CSS3, JS, AJAX, PHP y MySQL\Proyectos\barbershop\src\js\helper.js", "JavaScript", 0, 0, -77, -7, -28, -112
"c:\Users\Lorelvis\Documents\MEGASync\Programación\Desarrollo Web\Cursos\Desarrollo web completo con HTML5, CSS3, JS, AJAX, PHP y MySQL\Proyectos\barbershop\src\js\modernizr.js", "JavaScript", 0, 0, -1, -2, 0, -3
"c:\Users\Lorelvis\Documents\MEGASync\Programación\Desarrollo Web\Cursos\Desarrollo web completo con HTML5, CSS3, JS, AJAX, PHP y MySQL\Proyectos\barbershop\src\js\searchbar.js", "JavaScript", 0, 0, -76, -4, -23, -103
"c:\Users\Lorelvis\Documents\MEGASync\Programación\Desarrollo Web\Cursos\Desarrollo web completo con HTML5, CSS3, JS, AJAX, PHP y MySQL\Proyectos\barbershop\src\js\svg.js", "JavaScript", 0, 0, -268, -50, -64, -382
"c:\Users\Lorelvis\Documents\MEGASync\Programación\Desarrollo Web\Cursos\Desarrollo web completo con HTML5, CSS3, JS, AJAX, PHP y MySQL\Proyectos\barbershop\src\js\table.js", "JavaScript", 0, 0, -60, -10, -24, -94
"c:\Users\Lorelvis\Documents\MEGASync\Programación\Desarrollo Web\Cursos\Desarrollo web completo con HTML5, CSS3, JS, AJAX, PHP y MySQL\Proyectos\barbershop\src\js\users\admin.js", "JavaScript", 0, 0, 0, 0, -1, -1
"c:\Users\Lorelvis\Documents\MEGASync\Programación\Desarrollo Web\Cursos\Desarrollo web completo con HTML5, CSS3, JS, AJAX, PHP y MySQL\Proyectos\barbershop\src\js\users\customer.js", "JavaScript", 0, 0, -507, -39, -163, -709
"c:\Users\Lorelvis\Documents\MEGASync\Programación\Desarrollo Web\Cursos\Desarrollo web completo con HTML5, CSS3, JS, AJAX, PHP y MySQL\Proyectos\barbershop\src\js\users\employee.js", "JavaScript", 0, 0, -281, -5, -89, -375
"c:\Users\Lorelvis\Documents\MEGASync\Programación\Desarrollo Web\Cursos\Desarrollo web completo con HTML5, CSS3, JS, AJAX, PHP y MySQL\Proyectos\barbershop\src\scss\app.scss", "SCSS", 0, -3, 0, 0, 0, -3
"c:\Users\Lorelvis\Documents\MEGASync\Programación\Desarrollo Web\Cursos\Desarrollo web completo con HTML5, CSS3, JS, AJAX, PHP y MySQL\Proyectos\barbershop\src\scss\base\_globals.scss", "SCSS", 0, -46, 0, 0, -5, -51
"c:\Users\Lorelvis\Documents\MEGASync\Programación\Desarrollo Web\Cursos\Desarrollo web completo con HTML5, CSS3, JS, AJAX, PHP y MySQL\Proyectos\barbershop\src\scss\base\_index.scss", "SCSS", 0, -8, 0, 0, 0, -8
"c:\Users\Lorelvis\Documents\MEGASync\Programación\Desarrollo Web\Cursos\Desarrollo web completo con HTML5, CSS3, JS, AJAX, PHP y MySQL\Proyectos\barbershop\src\scss\base\_keen-slider.scss", "SCSS", 0, -4, 0, 0, 0, -4
"c:\Users\Lorelvis\Documents\MEGASync\Programación\Desarrollo Web\Cursos\Desarrollo web completo con HTML5, CSS3, JS, AJAX, PHP y MySQL\Proyectos\barbershop\src\scss\base\_mixins.scss", "SCSS", 0, -66, 0, -1, -12, -79
"c:\Users\Lorelvis\Documents\MEGASync\Programación\Desarrollo Web\Cursos\Desarrollo web completo con HTML5, CSS3, JS, AJAX, PHP y MySQL\Proyectos\barbershop\src\scss\base\_normalize.scss", "SCSS", 0, -146, 0, -129, -75, -350
"c:\Users\Lorelvis\Documents\MEGASync\Programación\Desarrollo Web\Cursos\Desarrollo web completo con HTML5, CSS3, JS, AJAX, PHP y MySQL\Proyectos\barbershop\src\scss\base\_properties.scss", "SCSS", 0, -19, 0, -4, -5, -28
"c:\Users\Lorelvis\Documents\MEGASync\Programación\Desarrollo Web\Cursos\Desarrollo web completo con HTML5, CSS3, JS, AJAX, PHP y MySQL\Proyectos\barbershop\src\scss\base\_scrollbar.scss", "SCSS", 0, -15, 0, -3, -3, -21
"c:\Users\Lorelvis\Documents\MEGASync\Programación\Desarrollo Web\Cursos\Desarrollo web completo con HTML5, CSS3, JS, AJAX, PHP y MySQL\Proyectos\barbershop\src\scss\base\_typography.scss", "SCSS", 0, -33, 0, 0, -2, -35
"c:\Users\Lorelvis\Documents\MEGASync\Programación\Desarrollo Web\Cursos\Desarrollo web completo con HTML5, CSS3, JS, AJAX, PHP y MySQL\Proyectos\barbershop\src\scss\base\_utilities.scss", "SCSS", 0, -32, 0, 0, -9, -41
"c:\Users\Lorelvis\Documents\MEGASync\Programación\Desarrollo Web\Cursos\Desarrollo web completo con HTML5, CSS3, JS, AJAX, PHP y MySQL\Proyectos\barbershop\src\scss\components\_actions.scss", "SCSS", 0, -20, 0, -5, -5, -30
"c:\Users\Lorelvis\Documents\MEGASync\Programación\Desarrollo Web\Cursos\Desarrollo web completo con HTML5, CSS3, JS, AJAX, PHP y MySQL\Proyectos\barbershop\src\scss\components\_alerts.scss", "SCSS", 0, -38, 0, 0, -8, -46
"c:\Users\Lorelvis\Documents\MEGASync\Programación\Desarrollo Web\Cursos\Desarrollo web completo con HTML5, CSS3, JS, AJAX, PHP y MySQL\Proyectos\barbershop\src\scss\components\_appointment.scss", "SCSS", 0, -2, 0, 0, -2, -4
"c:\Users\Lorelvis\Documents\MEGASync\Programación\Desarrollo Web\Cursos\Desarrollo web completo con HTML5, CSS3, JS, AJAX, PHP y MySQL\Proyectos\barbershop\src\scss\components\_bar.scss", "SCSS", 0, -35, 0, 0, -9, -44
"c:\Users\Lorelvis\Documents\MEGASync\Programación\Desarrollo Web\Cursos\Desarrollo web completo con HTML5, CSS3, JS, AJAX, PHP y MySQL\Proyectos\barbershop\src\scss\components\_buttons.scss", "SCSS", 0, -16, 0, 0, -2, -18
"c:\Users\Lorelvis\Documents\MEGASync\Programación\Desarrollo Web\Cursos\Desarrollo web completo con HTML5, CSS3, JS, AJAX, PHP y MySQL\Proyectos\barbershop\src\scss\components\_crud-actions.scss", "SCSS", 0, -12, 0, 0, -2, -14
"c:\Users\Lorelvis\Documents\MEGASync\Programación\Desarrollo Web\Cursos\Desarrollo web completo con HTML5, CSS3, JS, AJAX, PHP y MySQL\Proyectos\barbershop\src\scss\components\_employees-slider.scss", "SCSS", 0, -75, 0, 0, -14, -89
"c:\Users\Lorelvis\Documents\MEGASync\Programación\Desarrollo Web\Cursos\Desarrollo web completo con HTML5, CSS3, JS, AJAX, PHP y MySQL\Proyectos\barbershop\src\scss\components\_flatpickr.scss", "SCSS", 0, -44, 0, 0, -14, -58
"c:\Users\Lorelvis\Documents\MEGASync\Programación\Desarrollo Web\Cursos\Desarrollo web completo con HTML5, CSS3, JS, AJAX, PHP y MySQL\Proyectos\barbershop\src\scss\components\_form.scss", "SCSS", 0, -62, 0, 0, -11, -73
"c:\Users\Lorelvis\Documents\MEGASync\Programación\Desarrollo Web\Cursos\Desarrollo web completo con HTML5, CSS3, JS, AJAX, PHP y MySQL\Proyectos\barbershop\src\scss\components\_index.scss", "SCSS", 0, -13, 0, 0, 0, -13
"c:\Users\Lorelvis\Documents\MEGASync\Programación\Desarrollo Web\Cursos\Desarrollo web completo con HTML5, CSS3, JS, AJAX, PHP y MySQL\Proyectos\barbershop\src\scss\components\_pagination.scss", "SCSS", 0, -33, 0, 0, -8, -41
"c:\Users\Lorelvis\Documents\MEGASync\Programación\Desarrollo Web\Cursos\Desarrollo web completo con HTML5, CSS3, JS, AJAX, PHP y MySQL\Proyectos\barbershop\src\scss\components\_search-bar.scss", "SCSS", 0, -49, 0, -7, -12, -68
"c:\Users\Lorelvis\Documents\MEGASync\Programación\Desarrollo Web\Cursos\Desarrollo web completo con HTML5, CSS3, JS, AJAX, PHP y MySQL\Proyectos\barbershop\src\scss\components\_services.scss", "SCSS", 0, -48, 0, 0, -9, -57
"c:\Users\Lorelvis\Documents\MEGASync\Programación\Desarrollo Web\Cursos\Desarrollo web completo con HTML5, CSS3, JS, AJAX, PHP y MySQL\Proyectos\barbershop\src\scss\components\_table.scss", "SCSS", 0, -76, 0, 0, -13, -89
"c:\Users\Lorelvis\Documents\MEGASync\Programación\Desarrollo Web\Cursos\Desarrollo web completo con HTML5, CSS3, JS, AJAX, PHP y MySQL\Proyectos\barbershop\src\scss\components\_tabs.scss", "SCSS", 0, -41, 0, -1, -7, -49
"c:\Users\Lorelvis\Documents\MEGASync\Programación\Desarrollo Web\Cursos\Desarrollo web completo con HTML5, CSS3, JS, AJAX, PHP y MySQL\Proyectos\barbershop\src\scss\layout\_customer.scss", "SCSS", 0, -7, 0, 0, -1, -8
"c:\Users\Lorelvis\Documents\MEGASync\Programación\Desarrollo Web\Cursos\Desarrollo web completo con HTML5, CSS3, JS, AJAX, PHP y MySQL\Proyectos\barbershop\src\scss\layout\_employee.scss", "SCSS", 0, -193, 0, 0, -38, -231
"c:\Users\Lorelvis\Documents\MEGASync\Programación\Desarrollo Web\Cursos\Desarrollo web completo con HTML5, CSS3, JS, AJAX, PHP y MySQL\Proyectos\barbershop\src\scss\layout\_index.scss", "SCSS", 0, -4, 0, 0, 0, -4
"c:\Users\Lorelvis\Documents\MEGASync\Programación\Desarrollo Web\Cursos\Desarrollo web completo con HTML5, CSS3, JS, AJAX, PHP y MySQL\Proyectos\barbershop\src\scss\layout\_summary.scss", "SCSS", 0, -45, 0, 0, -9, -54
"c:\Users\Lorelvis\Documents\MEGASync\Programación\Desarrollo Web\Cursos\Desarrollo web completo con HTML5, CSS3, JS, AJAX, PHP y MySQL\Proyectos\barbershop\src\scss\layout\_ui.scss", "SCSS", 0, -63, 0, -1, -15, -79
"c:\Users\Lorelvis\Documents\MEGASync\Programación\Desarrollo Web\Cursos\Desarrollo web completo con HTML5, CSS3, JS, AJAX, PHP y MySQL\Proyectos\barbershop\views\admin\index.php", "PHP", 10, 0, 0, 0, 2, 12
"c:\Users\Lorelvis\Documents\MEGASync\Programación\Desarrollo Web\Cursos\Desarrollo web completo con HTML5, CSS3, JS, AJAX, PHP y MySQL\Proyectos\barbershop\views\auth\forgot.php", "PHP", 18, 0, 0, 0, 4, 22
"c:\Users\Lorelvis\Documents\MEGASync\Programación\Desarrollo Web\Cursos\Desarrollo web completo con HTML5, CSS3, JS, AJAX, PHP y MySQL\Proyectos\barbershop\views\auth\login.php", "PHP", 22, 0, 0, 0, 5, 27
"c:\Users\Lorelvis\Documents\MEGASync\Programación\Desarrollo Web\Cursos\Desarrollo web completo con HTML5, CSS3, JS, AJAX, PHP y MySQL\Proyectos\barbershop\views\auth\message.php", "PHP", 6, 0, 0, 0, 1, 7
"c:\Users\Lorelvis\Documents\MEGASync\Programación\Desarrollo Web\Cursos\Desarrollo web completo con HTML5, CSS3, JS, AJAX, PHP y MySQL\Proyectos\barbershop\views\auth\recovery.php", "PHP", 24, 0, 0, 0, 5, 29
"c:\Users\Lorelvis\Documents\MEGASync\Programación\Desarrollo Web\Cursos\Desarrollo web completo con HTML5, CSS3, JS, AJAX, PHP y MySQL\Proyectos\barbershop\views\auth\register.php", "PHP", 37, 0, 0, 0, 9, 46
"c:\Users\Lorelvis\Documents\MEGASync\Programación\Desarrollo Web\Cursos\Desarrollo web completo con HTML5, CSS3, JS, AJAX, PHP y MySQL\Proyectos\barbershop\views\auth\verify.php", "PHP", 7, 0, 0, 0, 2, 9
"c:\Users\Lorelvis\Documents\MEGASync\Programación\Desarrollo Web\Cursos\Desarrollo web completo con HTML5, CSS3, JS, AJAX, PHP y MySQL\Proyectos\barbershop\views\crud\employees\create.php", "PHP", 19, 0, 0, 0, 5, 24
"c:\Users\Lorelvis\Documents\MEGASync\Programación\Desarrollo Web\Cursos\Desarrollo web completo con HTML5, CSS3, JS, AJAX, PHP y MySQL\Proyectos\barbershop\views\crud\employees\edit.php", "PHP", 0, 0, 0, 0, 1, 1
"c:\Users\Lorelvis\Documents\MEGASync\Programación\Desarrollo Web\Cursos\Desarrollo web completo con HTML5, CSS3, JS, AJAX, PHP y MySQL\Proyectos\barbershop\views\crud\employees\form.php", "PHP", 40, 0, 0, 0, 6, 46
"c:\Users\Lorelvis\Documents\MEGASync\Programación\Desarrollo Web\Cursos\Desarrollo web completo con HTML5, CSS3, JS, AJAX, PHP y MySQL\Proyectos\barbershop\views\crud\employees\read.php", "PHP", 43, 0, 0, 0, 7, 50
"c:\Users\Lorelvis\Documents\MEGASync\Programación\Desarrollo Web\Cursos\Desarrollo web completo con HTML5, CSS3, JS, AJAX, PHP y MySQL\Proyectos\barbershop\views\crud\employees\update.php", "PHP", 19, 0, 0, 0, 5, 24
"c:\Users\Lorelvis\Documents\MEGASync\Programación\Desarrollo Web\Cursos\Desarrollo web completo con HTML5, CSS3, JS, AJAX, PHP y MySQL\Proyectos\barbershop\views\crud\roles\create.php", "PHP", 19, 0, 0, 0, 5, 24
"c:\Users\Lorelvis\Documents\MEGASync\Programación\Desarrollo Web\Cursos\Desarrollo web completo con HTML5, CSS3, JS, AJAX, PHP y MySQL\Proyectos\barbershop\views\crud\roles\form.php", "PHP", 7, 0, 0, 0, 1, 8
"c:\Users\Lorelvis\Documents\MEGASync\Programación\Desarrollo Web\Cursos\Desarrollo web completo con HTML5, CSS3, JS, AJAX, PHP y MySQL\Proyectos\barbershop\views\crud\roles\read.php", "PHP", 40, 0, 0, 0, 10, 50
"c:\Users\Lorelvis\Documents\MEGASync\Programación\Desarrollo Web\Cursos\Desarrollo web completo con HTML5, CSS3, JS, AJAX, PHP y MySQL\Proyectos\barbershop\views\crud\roles\update.php", "PHP", 14, 0, 0, 0, 4, 18
"c:\Users\Lorelvis\Documents\MEGASync\Programación\Desarrollo Web\Cursos\Desarrollo web completo con HTML5, CSS3, JS, AJAX, PHP y MySQL\Proyectos\barbershop\views\crud\services\create.php", "PHP", 19, 0, 0, 0, 5, 24
"c:\Users\Lorelvis\Documents\MEGASync\Programación\Desarrollo Web\Cursos\Desarrollo web completo con HTML5, CSS3, JS, AJAX, PHP y MySQL\Proyectos\barbershop\views\crud\services\form.php", "PHP", 22, 0, 0, 0, 3, 25
"c:\Users\Lorelvis\Documents\MEGASync\Programación\Desarrollo Web\Cursos\Desarrollo web completo con HTML5, CSS3, JS, AJAX, PHP y MySQL\Proyectos\barbershop\views\crud\services\read.php", "PHP", 41, 0, 0, 0, 9, 50
"c:\Users\Lorelvis\Documents\MEGASync\Programación\Desarrollo Web\Cursos\Desarrollo web completo con HTML5, CSS3, JS, AJAX, PHP y MySQL\Proyectos\barbershop\views\crud\services\update.php", "PHP", 14, 0, 0, 0, 6, 20
"c:\Users\Lorelvis\Documents\MEGASync\Programación\Desarrollo Web\Cursos\Desarrollo web completo con HTML5, CSS3, JS, AJAX, PHP y MySQL\Proyectos\barbershop\views\customer\index.php", "PHP", 70, 0, 0, 0, 22, 92
"c:\Users\Lorelvis\Documents\MEGASync\Programación\Desarrollo Web\Cursos\Desarrollo web completo con HTML5, CSS3, JS, AJAX, PHP y MySQL\Proyectos\barbershop\views\employee\index.php", "PHP", 12, 0, 0, 23, 5, 40
"c:\Users\Lorelvis\Documents\MEGASync\Programación\Desarrollo Web\Cursos\Desarrollo web completo con HTML5, CSS3, JS, AJAX, PHP y MySQL\Proyectos\barbershop\views\layout.php", "PHP", 25, 0, 0, 0, 6, 31
"c:\Users\Lorelvis\Documents\MEGASync\Programación\Desarrollo Web\Cursos\Desarrollo web completo con HTML5, CSS3, JS, AJAX, PHP y MySQL\Proyectos\barbershop\views\templates\alerts.php", "PHP", 8, 0, 0, 0, 1, 9
"c:\Users\Lorelvis\Documents\MEGASync\Programación\Desarrollo Web\Cursos\Desarrollo web completo con HTML5, CSS3, JS, AJAX, PHP y MySQL\Proyectos\barbershop\views\templates\bar.php", "PHP", 35, 0, 0, 0, 4, 39
"Total", "-", 571, -1248, -1270, -245, -549, -2741