"filename", "language", "PHP", "comment", "blank", "total"
"c:\Users\Lorelvis\Documents\MEGASync\Programación\Desarrollo Web\Cursos\Desarrollo web completo con HTML5, CSS3, JS, AJAX, PHP y MySQL\Proyectos\barbershop\views\admin\index.php", "PHP", 10, 0, 2, 12
"c:\Users\Lorelvis\Documents\MEGASync\Programación\Desarrollo Web\Cursos\Desarrollo web completo con HTML5, CSS3, JS, AJAX, PHP y MySQL\Proyectos\barbershop\views\auth\forgot.php", "PHP", 18, 0, 4, 22
"c:\Users\Lorelvis\Documents\MEGASync\Programación\Desarrollo Web\Cursos\Desarrollo web completo con HTML5, CSS3, JS, AJAX, PHP y MySQL\Proyectos\barbershop\views\auth\login.php", "PHP", 22, 0, 5, 27
"c:\Users\Lorelvis\Documents\MEGASync\Programación\Desarrollo Web\Cursos\Desarrollo web completo con HTML5, CSS3, JS, AJAX, PHP y MySQL\Proyectos\barbershop\views\auth\message.php", "PHP", 6, 0, 1, 7
"c:\Users\Lorelvis\Documents\MEGASync\Programación\Desarrollo Web\Cursos\Desarrollo web completo con HTML5, CSS3, JS, AJAX, PHP y MySQL\Proyectos\barbershop\views\auth\recovery.php", "PHP", 24, 0, 5, 29
"c:\Users\Lorelvis\Documents\MEGASync\Programación\Desarrollo Web\Cursos\Desarrollo web completo con HTML5, CSS3, JS, AJAX, PHP y MySQL\Proyectos\barbershop\views\auth\register.php", "PHP", 37, 0, 9, 46
"c:\Users\Lorelvis\Documents\MEGASync\Programación\Desarrollo Web\Cursos\Desarrollo web completo con HTML5, CSS3, JS, AJAX, PHP y MySQL\Proyectos\barbershop\views\auth\verify.php", "PHP", 7, 0, 2, 9
"c:\Users\Lorelvis\Documents\MEGASync\Programación\Desarrollo Web\Cursos\Desarrollo web completo con HTML5, CSS3, JS, AJAX, PHP y MySQL\Proyectos\barbershop\views\crud\employees\create.php", "PHP", 19, 0, 5, 24
"c:\Users\Lorelvis\Documents\MEGASync\Programación\Desarrollo Web\Cursos\Desarrollo web completo con HTML5, CSS3, JS, AJAX, PHP y MySQL\Proyectos\barbershop\views\crud\employees\edit.php", "PHP", 0, 0, 1, 1
"c:\Users\Lorelvis\Documents\MEGASync\Programación\Desarrollo Web\Cursos\Desarrollo web completo con HTML5, CSS3, JS, AJAX, PHP y MySQL\Proyectos\barbershop\views\crud\employees\form.php", "PHP", 40, 0, 6, 46
"c:\Users\Lorelvis\Documents\MEGASync\Programación\Desarrollo Web\Cursos\Desarrollo web completo con HTML5, CSS3, JS, AJAX, PHP y MySQL\Proyectos\barbershop\views\crud\employees\read.php", "PHP", 43, 0, 7, 50
"c:\Users\Lorelvis\Documents\MEGASync\Programación\Desarrollo Web\Cursos\Desarrollo web completo con HTML5, CSS3, JS, AJAX, PHP y MySQL\Proyectos\barbershop\views\crud\employees\update.php", "PHP", 19, 0, 5, 24
"c:\Users\Lorelvis\Documents\MEGASync\Programación\Desarrollo Web\Cursos\Desarrollo web completo con HTML5, CSS3, JS, AJAX, PHP y MySQL\Proyectos\barbershop\views\crud\roles\create.php", "PHP", 19, 0, 5, 24
"c:\Users\Lorelvis\Documents\MEGASync\Programación\Desarrollo Web\Cursos\Desarrollo web completo con HTML5, CSS3, JS, AJAX, PHP y MySQL\Proyectos\barbershop\views\crud\roles\form.php", "PHP", 7, 0, 1, 8
"c:\Users\Lorelvis\Documents\MEGASync\Programación\Desarrollo Web\Cursos\Desarrollo web completo con HTML5, CSS3, JS, AJAX, PHP y MySQL\Proyectos\barbershop\views\crud\roles\read.php", "PHP", 40, 0, 10, 50
"c:\Users\Lorelvis\Documents\MEGASync\Programación\Desarrollo Web\Cursos\Desarrollo web completo con HTML5, CSS3, JS, AJAX, PHP y MySQL\Proyectos\barbershop\views\crud\roles\update.php", "PHP", 14, 0, 4, 18
"c:\Users\Lorelvis\Documents\MEGASync\Programación\Desarrollo Web\Cursos\Desarrollo web completo con HTML5, CSS3, JS, AJAX, PHP y MySQL\Proyectos\barbershop\views\crud\services\create.php", "PHP", 19, 0, 5, 24
"c:\Users\Lorelvis\Documents\MEGASync\Programación\Desarrollo Web\Cursos\Desarrollo web completo con HTML5, CSS3, JS, AJAX, PHP y MySQL\Proyectos\barbershop\views\crud\services\form.php", "PHP", 22, 0, 3, 25
"c:\Users\Lorelvis\Documents\MEGASync\Programación\Desarrollo Web\Cursos\Desarrollo web completo con HTML5, CSS3, JS, AJAX, PHP y MySQL\Proyectos\barbershop\views\crud\services\read.php", "PHP", 41, 0, 9, 50
"c:\Users\Lorelvis\Documents\MEGASync\Programación\Desarrollo Web\Cursos\Desarrollo web completo con HTML5, CSS3, JS, AJAX, PHP y MySQL\Proyectos\barbershop\views\crud\services\update.php", "PHP", 14, 0, 6, 20
"c:\Users\Lorelvis\Documents\MEGASync\Programación\Desarrollo Web\Cursos\Desarrollo web completo con HTML5, CSS3, JS, AJAX, PHP y MySQL\Proyectos\barbershop\views\customer\index.php", "PHP", 70, 0, 22, 92
"c:\Users\Lorelvis\Documents\MEGASync\Programación\Desarrollo Web\Cursos\Desarrollo web completo con HTML5, CSS3, JS, AJAX, PHP y MySQL\Proyectos\barbershop\views\employee\index.php", "PHP", 12, 23, 5, 40
"c:\Users\Lorelvis\Documents\MEGASync\Programación\Desarrollo Web\Cursos\Desarrollo web completo con HTML5, CSS3, JS, AJAX, PHP y MySQL\Proyectos\barbershop\views\layout.php", "PHP", 25, 0, 6, 31
"c:\Users\Lorelvis\Documents\MEGASync\Programación\Desarrollo Web\Cursos\Desarrollo web completo con HTML5, CSS3, JS, AJAX, PHP y MySQL\Proyectos\barbershop\views\templates\alerts.php", "PHP", 8, 0, 1, 9
"c:\Users\Lorelvis\Documents\MEGASync\Programación\Desarrollo Web\Cursos\Desarrollo web completo con HTML5, CSS3, JS, AJAX, PHP y MySQL\Proyectos\barbershop\views\templates\bar.php", "PHP", 35, 0, 4, 39
"Total", "-", 571, 23, 133, 727