"filename", "language", "SCSS", "JavaScript", "comment", "blank", "total"
"c:\Users\Lorelvis\Documents\MEGASync\Programación\Desarrollo Web\Cursos\Desarrollo web completo con HTML5, CSS3, JS, AJAX, PHP y MySQL\Proyectos\barbershop\src\js\helper.js", "JavaScript", 0, 77, 7, 28, 112
"c:\Users\Lorelvis\Documents\MEGASync\Programación\Desarrollo Web\Cursos\Desarrollo web completo con HTML5, CSS3, JS, AJAX, PHP y MySQL\Proyectos\barbershop\src\js\modernizr.js", "JavaScript", 0, 1, 2, 0, 3
"c:\Users\Lorelvis\Documents\MEGASync\Programación\Desarrollo Web\Cursos\Desarrollo web completo con HTML5, CSS3, JS, AJAX, PHP y MySQL\Proyectos\barbershop\src\js\searchbar.js", "JavaScript", 0, 76, 4, 23, 103
"c:\Users\Lorelvis\Documents\MEGASync\Programación\Desarrollo Web\Cursos\Desarrollo web completo con HTML5, CSS3, JS, AJAX, PHP y MySQL\Proyectos\barbershop\src\js\svg.js", "JavaScript", 0, 268, 50, 64, 382
"c:\Users\Lorelvis\Documents\MEGASync\Programación\Desarrollo Web\Cursos\Desarrollo web completo con HTML5, CSS3, JS, AJAX, PHP y MySQL\Proyectos\barbershop\src\js\table.js", "JavaScript", 0, 60, 10, 24, 94
"c:\Users\Lorelvis\Documents\MEGASync\Programación\Desarrollo Web\Cursos\Desarrollo web completo con HTML5, CSS3, JS, AJAX, PHP y MySQL\Proyectos\barbershop\src\js\users\admin.js", "JavaScript", 0, 0, 0, 1, 1
"c:\Users\Lorelvis\Documents\MEGASync\Programación\Desarrollo Web\Cursos\Desarrollo web completo con HTML5, CSS3, JS, AJAX, PHP y MySQL\Proyectos\barbershop\src\js\users\customer.js", "JavaScript", 0, 507, 39, 163, 709
"c:\Users\Lorelvis\Documents\MEGASync\Programación\Desarrollo Web\Cursos\Desarrollo web completo con HTML5, CSS3, JS, AJAX, PHP y MySQL\Proyectos\barbershop\src\js\users\employee.js", "JavaScript", 0, 281, 5, 89, 375
"c:\Users\Lorelvis\Documents\MEGASync\Programación\Desarrollo Web\Cursos\Desarrollo web completo con HTML5, CSS3, JS, AJAX, PHP y MySQL\Proyectos\barbershop\src\scss\app.scss", "SCSS", 3, 0, 0, 0, 3
"c:\Users\Lorelvis\Documents\MEGASync\Programación\Desarrollo Web\Cursos\Desarrollo web completo con HTML5, CSS3, JS, AJAX, PHP y MySQL\Proyectos\barbershop\src\scss\base\_globals.scss", "SCSS", 46, 0, 0, 5, 51
"c:\Users\Lorelvis\Documents\MEGASync\Programación\Desarrollo Web\Cursos\Desarrollo web completo con HTML5, CSS3, JS, AJAX, PHP y MySQL\Proyectos\barbershop\src\scss\base\_index.scss", "SCSS", 8, 0, 0, 0, 8
"c:\Users\Lorelvis\Documents\MEGASync\Programación\Desarrollo Web\Cursos\Desarrollo web completo con HTML5, CSS3, JS, AJAX, PHP y MySQL\Proyectos\barbershop\src\scss\base\_keen-slider.scss", "SCSS", 4, 0, 0, 0, 4
"c:\Users\Lorelvis\Documents\MEGASync\Programación\Desarrollo Web\Cursos\Desarrollo web completo con HTML5, CSS3, JS, AJAX, PHP y MySQL\Proyectos\barbershop\src\scss\base\_mixins.scss", "SCSS", 66, 0, 1, 12, 79
"c:\Users\Lorelvis\Documents\MEGASync\Programación\Desarrollo Web\Cursos\Desarrollo web completo con HTML5, CSS3, JS, AJAX, PHP y MySQL\Proyectos\barbershop\src\scss\base\_normalize.scss", "SCSS", 146, 0, 129, 75, 350
"c:\Users\Lorelvis\Documents\MEGASync\Programación\Desarrollo Web\Cursos\Desarrollo web completo con HTML5, CSS3, JS, AJAX, PHP y MySQL\Proyectos\barbershop\src\scss\base\_properties.scss", "SCSS", 19, 0, 4, 5, 28
"c:\Users\Lorelvis\Documents\MEGASync\Programación\Desarrollo Web\Cursos\Desarrollo web completo con HTML5, CSS3, JS, AJAX, PHP y MySQL\Proyectos\barbershop\src\scss\base\_scrollbar.scss", "SCSS", 15, 0, 3, 3, 21
"c:\Users\Lorelvis\Documents\MEGASync\Programación\Desarrollo Web\Cursos\Desarrollo web completo con HTML5, CSS3, JS, AJAX, PHP y MySQL\Proyectos\barbershop\src\scss\base\_typography.scss", "SCSS", 33, 0, 0, 2, 35
"c:\Users\Lorelvis\Documents\MEGASync\Programación\Desarrollo Web\Cursos\Desarrollo web completo con HTML5, CSS3, JS, AJAX, PHP y MySQL\Proyectos\barbershop\src\scss\base\_utilities.scss", "SCSS", 32, 0, 0, 9, 41
"c:\Users\Lorelvis\Documents\MEGASync\Programación\Desarrollo Web\Cursos\Desarrollo web completo con HTML5, CSS3, JS, AJAX, PHP y MySQL\Proyectos\barbershop\src\scss\components\_actions.scss", "SCSS", 20, 0, 5, 5, 30
"c:\Users\Lorelvis\Documents\MEGASync\Programación\Desarrollo Web\Cursos\Desarrollo web completo con HTML5, CSS3, JS, AJAX, PHP y MySQL\Proyectos\barbershop\src\scss\components\_alerts.scss", "SCSS", 38, 0, 0, 8, 46
"c:\Users\Lorelvis\Documents\MEGASync\Programación\Desarrollo Web\Cursos\Desarrollo web completo con HTML5, CSS3, JS, AJAX, PHP y MySQL\Proyectos\barbershop\src\scss\components\_appointment.scss", "SCSS", 2, 0, 0, 2, 4
"c:\Users\Lorelvis\Documents\MEGASync\Programación\Desarrollo Web\Cursos\Desarrollo web completo con HTML5, CSS3, JS, AJAX, PHP y MySQL\Proyectos\barbershop\src\scss\components\_bar.scss", "SCSS", 35, 0, 0, 9, 44
"c:\Users\Lorelvis\Documents\MEGASync\Programación\Desarrollo Web\Cursos\Desarrollo web completo con HTML5, CSS3, JS, AJAX, PHP y MySQL\Proyectos\barbershop\src\scss\components\_buttons.scss", "SCSS", 16, 0, 0, 2, 18
"c:\Users\Lorelvis\Documents\MEGASync\Programación\Desarrollo Web\Cursos\Desarrollo web completo con HTML5, CSS3, JS, AJAX, PHP y MySQL\Proyectos\barbershop\src\scss\components\_crud-actions.scss", "SCSS", 12, 0, 0, 2, 14
"c:\Users\Lorelvis\Documents\MEGASync\Programación\Desarrollo Web\Cursos\Desarrollo web completo con HTML5, CSS3, JS, AJAX, PHP y MySQL\Proyectos\barbershop\src\scss\components\_employees-slider.scss", "SCSS", 75, 0, 0, 14, 89
"c:\Users\Lorelvis\Documents\MEGASync\Programación\Desarrollo Web\Cursos\Desarrollo web completo con HTML5, CSS3, JS, AJAX, PHP y MySQL\Proyectos\barbershop\src\scss\components\_flatpickr.scss", "SCSS", 44, 0, 0, 14, 58
"c:\Users\Lorelvis\Documents\MEGASync\Programación\Desarrollo Web\Cursos\Desarrollo web completo con HTML5, CSS3, JS, AJAX, PHP y MySQL\Proyectos\barbershop\src\scss\components\_form.scss", "SCSS", 62, 0, 0, 11, 73
"c:\Users\Lorelvis\Documents\MEGASync\Programación\Desarrollo Web\Cursos\Desarrollo web completo con HTML5, CSS3, JS, AJAX, PHP y MySQL\Proyectos\barbershop\src\scss\components\_index.scss", "SCSS", 13, 0, 0, 0, 13
"c:\Users\Lorelvis\Documents\MEGASync\Programación\Desarrollo Web\Cursos\Desarrollo web completo con HTML5, CSS3, JS, AJAX, PHP y MySQL\Proyectos\barbershop\src\scss\components\_pagination.scss", "SCSS", 33, 0, 0, 8, 41
"c:\Users\Lorelvis\Documents\MEGASync\Programación\Desarrollo Web\Cursos\Desarrollo web completo con HTML5, CSS3, JS, AJAX, PHP y MySQL\Proyectos\barbershop\src\scss\components\_search-bar.scss", "SCSS", 49, 0, 7, 12, 68
"c:\Users\Lorelvis\Documents\MEGASync\Programación\Desarrollo Web\Cursos\Desarrollo web completo con HTML5, CSS3, JS, AJAX, PHP y MySQL\Proyectos\barbershop\src\scss\components\_services.scss", "SCSS", 48, 0, 0, 9, 57
"c:\Users\Lorelvis\Documents\MEGASync\Programación\Desarrollo Web\Cursos\Desarrollo web completo con HTML5, CSS3, JS, AJAX, PHP y MySQL\Proyectos\barbershop\src\scss\components\_table.scss", "SCSS", 76, 0, 0, 13, 89
"c:\Users\Lorelvis\Documents\MEGASync\Programación\Desarrollo Web\Cursos\Desarrollo web completo con HTML5, CSS3, JS, AJAX, PHP y MySQL\Proyectos\barbershop\src\scss\components\_tabs.scss", "SCSS", 41, 0, 1, 7, 49
"c:\Users\Lorelvis\Documents\MEGASync\Programación\Desarrollo Web\Cursos\Desarrollo web completo con HTML5, CSS3, JS, AJAX, PHP y MySQL\Proyectos\barbershop\src\scss\layout\_customer.scss", "SCSS", 7, 0, 0, 1, 8
"c:\Users\Lorelvis\Documents\MEGASync\Programación\Desarrollo Web\Cursos\Desarrollo web completo con HTML5, CSS3, JS, AJAX, PHP y MySQL\Proyectos\barbershop\src\scss\layout\_employee.scss", "SCSS", 193, 0, 0, 38, 231
"c:\Users\Lorelvis\Documents\MEGASync\Programación\Desarrollo Web\Cursos\Desarrollo web completo con HTML5, CSS3, JS, AJAX, PHP y MySQL\Proyectos\barbershop\src\scss\layout\_index.scss", "SCSS", 4, 0, 0, 0, 4
"c:\Users\Lorelvis\Documents\MEGASync\Programación\Desarrollo Web\Cursos\Desarrollo web completo con HTML5, CSS3, JS, AJAX, PHP y MySQL\Proyectos\barbershop\src\scss\layout\_summary.scss", "SCSS", 45, 0, 0, 9, 54
"c:\Users\Lorelvis\Documents\MEGASync\Programación\Desarrollo Web\Cursos\Desarrollo web completo con HTML5, CSS3, JS, AJAX, PHP y MySQL\Proyectos\barbershop\src\scss\layout\_ui.scss", "SCSS", 63, 0, 1, 15, 79
"Total", "-", 1248, 1270, 268, 682, 3468